0 0 0 0 0 0
R B 0 G 0 0
0 Y 0 0 0 0
0 O 0 0 0 R
0 Y 0 0 G B
O 0 0 0 0 0
