Y 0 0 0 0 0
0 0 0 0 0 0
0 0 0 0 0 0
R G B G 0 0
Y B 0 R 0 0
0 0 0 0 0 0
