0 0 0 0 B G
0 0 R 0 0 0
0 0 O 0 0 0
0 0 Y G 0 0
0 R 0 0 B 0
0 O Y 0 0 0
