0 0 0 0 0 0
0 B O 0 O R
0 0 0 0 0 B
0 0 0 0 R G
G Y 0 0 Y 0
0 0 0 0 0 0
