0 0 0 0 O 0
0 0 G 0 B 0
0 0 0 0 0 0
0 0 0 R 0 0
0 0 0 0 0 O
Y G Y R 0 B
