B 0 0 0 0 R
Y 0 0 0 0 0
O G 0 0 0 0
0 0 G Y 0 0
R 0 O B 0 0
0 0 0 0 0 0
