R 0 0 0 0 0
G 0 0 0 0 0
0 0 0 O 0 0
O 0 0 B 0 0
0 0 Y G 0 0
B Y 0 R 0 0
