0 0 0 0 0 0 0 G 0
0 B Y 0 0 0 0 0 0
O 0 0 0 0 0 0 0 0
P 0 0 0 0 R Y 0 0
0 0 O 0 B 0 0 0 G
0 0 0 0 C R 0 0 C
0 0 0 0 0 0 0 0 P
0 0 0 0 0 0 0 0 0
0 0 0 0 0 0 0 0 0