0 0 0 Y 0 0 0 0 0
0 P 0 0 0 0 0 0 0
O 0 0 0 0 G B 0 0
B P 0 Y 0 0 0 0 0
0 0 0 0 0 0 0 0 0
O 0 0 0 0 0 0 R 0
0 0 R 0 0 0 G 0 0
C 0 0 0 0 0 0 0 0
0 0 0 C 0 0 0 0 0