0 0 0 0 0 0 Y 0 0
G 0 0 0 C 0 0 R 0
0 0 0 0 0 Y 0 0 0
0 0 0 0 B G 0 0 0
0 0 0 0 0 0 0 0 0
0 0 0 0 0 0 0 0 0
0 0 B R 0 0 0 0 0
0 0 0 0 0 0 0 W 0
0 0 0 0 0 0 W 0 C