0 0 0 0 0 0 B P 0
0 0 0 0 0 0 C B 0
0 0 0 0 0 0 0 0 0
0 0 0 0 0 0 0 0 0
0 0 0 0 Y R 0 0 G
0 0 0 P 0 0 G 0 0
0 0 0 0 W 0 0 R 0
0 0 C 0 0 0 0 0 0
0 0 0 0 W 0 0 0 Y