0 0 0 0 R 0 0 0
0 0 0 0 C 0 G Y
0 0 0 0 G Y 0 C
0 0 0 W B 0 0 0
0 0 0 0 W 0 0 0
0 0 0 0 B 0 0 0
0 0 0 0 0 0 0 0
0 R 0 0 0 0 0 0