0 0 0 0 W P W 0
0 0 0 0 R 0 C 0
0 0 G 0 0 0 0 0
0 0 0 0 0 P C 0
0 0 G B 0 0 0 0
0 0 0 0 0 Y 0 0
0 B Y R 0 0 0 0
0 0 0 0 0 0 0 0