0 R 0 0 0 0 0 0
0 0 0 Y 0 0 Y 0
0 0 B 0 0 0 0 0
0 0 0 0 0 0 0 0
0 0 0 R C 0 0 G
0 0 0 W 0 0 0 B
0 C 0 0 0 0 0 0
0 0 0 0 0 0 W G