0 0 0 0 0 0 0 0
0 0 0 0 R B Y 0
0 0 G 0 0 0 0 0
0 0 0 0 0 0 0 0
0 0 0 0 W 0 0 0
0 0 G 0 B R 0 0
0 0 0 0 0 Y 0 0
0 0 0 0 0 0 0 W