0 0 0 0 G 0 Y 0
0 G 0 0 C 0 0 0
0 B 0 0 R W 0 0
0 0 0 0 0 0 0 0
0 0 0 0 W R 0 0
C 0 0 0 0 0 0 0
Y B 0 0 0 0 0 0
0 0 0 0 0 0 0 0