0 G 0 0 0 0 0 0
0 0 0 0 0 0 0 0
0 0 0 0 Y B 0 0
0 0 0 0 0 0 R 0
0 0 0 Y W 0 0 0
0 0 0 0 0 0 0 W
0 0 B 0 0 C 0 C
0 0 0 G 0 0 0 R