G 0 0 0 0 0 P G
0 0 0 0 W 0 0 0
0 0 0 0 C 0 0 0
0 0 R 0 B 0 0 0
W 0 0 0 Y 0 0 0
Y 0 R 0 0 0 0 0
0 0 C B 0 0 P 0
0 0 0 0 0 0 0 0