0 0 0 0 0 0 0 0
0 P 0 0 0 0 0 W
0 0 0 0 0 0 0 C
0 0 0 0 0 0 0 0
0 0 0 0 0 0 0 0
0 0 G 0 0 Y 0 0
0 0 B P Y C 0 R
0 0 0 W R 0 0 0