B Y 0 0 0
0 0 G 0 0
R 0 B 0 0
0 0 0 0 0
R G Y 0 0