0 P R 0 0 0 0
0 0 O B 0 B 0
0 0 G 0 0 0 0
0 0 C Y 0 G 0
0 0 0 0 Y C 0
0 0 O 0 0 0 0
0 0 P R 0 0 0