0 0 0 0 0 0 0
0 0 0 0 0 0 0
0 R B 0 B 0 0
0 C 0 0 0 0 0
0 0 0 G C R 0
G Y 0 O Y 0 0
0 0 0 0 0 0 O