0 0 0 0 0 0 0
C R 0 R 0 G 0
0 0 P C G 0 0
0 0 Y 0 0 0 B
0 0 O 0 0 0 0
0 0 0 0 Y 0 B
0 0 0 0 P 0 O