0 0 0 0 0 O R
O C G 0 0 0 0
0 0 0 0 B 0 B
0 Y 0 0 0 0 R
0 0 0 0 0 G C
0 0 0 0 0 Y 0
0 0 0 0 0 0 0