0 0 0 0 0 0 0
0 0 0 0 0 R 0
G R O G 0 0 0
C P 0 0 0 0 Y
0 0 0 Y 0 0 0
0 0 0 0 0 B 0
C P B 0 0 0 O