0 0 0 Y 0 0 0
0 0 0 0 0 C 0
0 0 0 0 0 0 0
0 0 0 0 0 G R
0 0 0 G 0 C B
0 0 0 0 0 O 0
Y R O 0 0 0 B