G 0 G R 0 0 0
0 0 R O 0 0 0
0 B 0 0 Y 0 0
0 Y 0 B 0 0 0
0 O 0 0 0 0 0
0 0 0 0 0 0 0
0 0 0 0 0 0 0