G 0 0 0 R 0 C
0 0 0 0 0 0 O
0 0 0 0 0 0 0
0 0 0 O Y 0 0
0 0 0 C G B 0
0 0 0 R 0 0 0
0 0 0 0 0 B Y