P 0 G 0 0 B 0
Y 0 0 P 0 R 0
0 0 0 Y 0 0 0
0 0 0 R G 0 0
C O 0 0 0 0 0
0 0 0 0 0 C 0
O B 0 0 0 0 0