0 0 0 0 R 0 0 0
0 0 0 0 C 0 G Y
0 0 0 0 G Y 0 C
0 0 0 W B 0 0 0
0 0 0 0 W 0 0 0
0 0 0 0 B 0 0 0
0 0 0 0 0 0 0 0
0 R 0 0 0 0 0 0

0 R 0 0 0 0 0 0
0 0 0 Y 0 0 Y 0
0 0 B 0 0 0 0 0
0 0 0 0 0 0 0 0
0 0 0 R C 0 0 G
0 0 0 W 0 0 0 B
0 C 0 0 0 0 0 0
0 0 0 0 0 0 W G

0 0 0 0 0 0 0 0
0 0 0 0 R B Y 0
0 0 G 0 0 0 0 0
0 0 0 0 0 0 0 0
0 0 0 0 W 0 0 0
0 0 G 0 B R 0 0
0 0 0 0 0 Y 0 0
0 0 0 0 0 0 0 W

0 0 0 0 G 0 Y 0
0 G 0 0 C 0 0 0
0 B 0 0 R W 0 0
0 0 0 0 0 0 0 0
0 0 0 0 W R 0 0
C 0 0 0 0 0 0 0
Y B 0 0 0 0 0 0
0 0 0 0 0 0 0 0

0 0 0 0 0 0 0 Y
0 0 0 0 0 0 G C
0 0 0 0 0 0 0 0
0 0 0 0 W B 0 0
0 0 0 0 B 0 0 0
0 0 R 0 0 W 0 0
0 0 0 0 0 0 R 0
0 0 0 0 Y 0 G C

0 G 0 0 0 0 0 0
0 0 0 0 0 0 0 0
0 0 0 0 Y B 0 0
0 0 0 0 0 0 R 0
0 0 0 Y W 0 0 0
0 0 0 0 0 0 0 W
0 0 B 0 0 C 0 C
0 0 0 G 0 0 0 R

G 0 0 0 0 0 P G
0 0 0 0 W 0 0 0
0 0 0 0 C 0 0 0
0 0 R 0 B 0 0 0
W 0 0 0 Y 0 0 0
Y 0 R 0 0 0 0 0
0 0 C B 0 0 P 0
0 0 0 0 0 0 0 0

0 0 0 0 0 0 0 0
0 P 0 0 0 0 0 W
0 0 0 0 0 0 0 C
0 0 0 0 0 0 0 0
0 0 0 0 0 0 0 0
0 0 G 0 0 Y 0 0
0 0 B P Y C 0 R
0 0 0 W R 0 0 0

C 0 0 0 0 0 0 R
0 0 0 0 0 0 Y 0
0 0 0 G 0 0 W 0
0 0 0 0 0 0 0 Y
0 0 R 0 0 W 0 0
0 0 0 0 0 B C 0
0 B 0 0 0 0 0 0
0 0 0 G 0 0 0 0

0 0 0 0 W P W 0
0 0 0 0 R 0 C 0
0 0 G 0 0 0 0 0
0 0 0 0 0 P C 0
0 0 G B 0 0 0 0
0 0 0 0 0 Y 0 0
0 B Y R 0 0 0 0
0 0 0 0 0 0 0 0