0 0 0 0 0 0 0 G 0
0 B Y 0 0 0 0 0 0
W 0 0 0 0 0 0 0 0
P 0 0 0 0 R Y 0 0
0 0 W 0 B 0 0 0 G
0 0 0 0 C R 0 0 C
0 0 0 0 0 0 0 0 P
0 0 0 0 0 0 0 0 0
0 0 0 0 0 0 0 0 0

Y W 0 0 0 0 0 0 C
0 0 0 W 0 0 0 0 G
0 0 0 0 0 0 0 0 0
0 0 0 0 G 0 0 Y R
0 0 0 0 R 0 0 0 B
0 0 0 0 0 0 0 0 P
0 0 0 0 C 0 0 0 0
0 0 0 0 0 0 0 0 P
0 0 0 0 0 0 0 0 B

0 0 0 0 0 0 0 0 0
0 0 0 0 0 0 0 0 0
0 0 R 0 0 0 P 0 0
0 0 0 0 0 0 0 0 0
0 0 0 Y 0 0 0 0 0
0 C 0 0 0 0 P 0 0
0 G 0 0 0 0 R 0 G
0 Y 0 0 0 W B 0 W
0 0 0 0 0 C 0 0 B

0 0 0 Y 0 0 0 0 0
0 P 0 0 0 0 0 0 0
W 0 0 0 0 G B 0 0
B P 0 Y 0 0 0 0 0
0 0 0 0 0 0 0 0 0
W 0 0 0 0 0 0 R 0
0 0 R 0 0 0 G 0 0
C 0 0 0 0 0 0 0 0
0 0 0 C 0 0 0 0 0

0 0 0 0 0 0 Y 0 0
G 0 0 0 C 0 0 R 0
0 0 0 0 0 Y 0 0 0
0 0 0 0 B G 0 0 0
0 0 0 0 0 0 0 0 0
0 0 0 0 0 0 0 0 0
0 0 B R 0 0 0 0 0
0 0 0 0 0 0 0 W 0
0 0 0 0 0 0 W 0 C

0 0 0 0 0 0 B P 0
0 0 0 0 0 0 C B 0
0 0 0 0 0 0 0 0 0
0 0 0 0 0 0 0 0 0
0 0 0 0 Y R 0 0 G
0 0 0 P 0 0 G 0 0
0 0 0 0 W 0 0 R 0
0 0 C 0 0 0 0 0 0
0 0 0 0 W 0 0 0 Y

Y 0 0 0 0 0 0 0 0
0 0 0 0 0 0 0 0 0
0 0 0 0 0 0 0 0 0
0 Y 0 0 0 0 0 0 0
0 W 0 0 C 0 0 0 0
0 0 R 0 W 0 0 0 0
0 0 B 0 0 P 0 0 0
0 R 0 0 0 0 0 G 0
0 0 G B C P 0 0 0