0 P R 0 0 0 0
0 0 W B 0 B 0
0 0 G 0 0 0 0
0 0 C Y 0 G 0
0 0 0 0 Y C 0
0 0 W 0 0 0 0
0 0 P R 0 0 0

0 0 0 0 0 0 0
C R 0 R 0 G 0
0 0 P C G 0 0
0 0 Y 0 0 0 B
0 0 W 0 0 0 0
0 0 0 0 Y 0 B
0 0 0 0 P 0 W

0 0 0 0 0 W R
W C G 0 0 0 0
0 0 0 0 B 0 B
0 Y 0 0 0 0 R
0 0 0 0 0 G C
0 0 0 0 0 Y 0
0 0 0 0 0 0 0

0 0 0 0 0 0 0
0 0 0 0 0 R 0
G R W G 0 0 0
C P 0 0 0 0 Y
0 0 0 Y 0 0 0
0 0 0 0 0 B 0
C P B 0 0 0 W

0 0 0 0 0 0 0
B G 0 0 0 0 0
Y 0 0 0 Y 0 0
0 0 0 0 0 0 B
0 R 0 0 0 0 0
0 0 0 G 0 W 0
W 0 0 0 0 R 0

0 0 0 Y 0 0 0
0 0 0 0 0 C 0
0 0 0 0 0 0 0
0 0 0 0 0 G R
0 0 0 G 0 C B
0 0 0 0 0 W 0
Y R W 0 0 0 B

G 0 G R 0 0 0
0 0 R W 0 0 0
0 B 0 0 Y 0 0
0 Y 0 B 0 0 0
0 W 0 0 0 0 0
0 0 0 0 0 0 0
0 0 0 0 0 0 0

G 0 0 0 R 0 C
0 0 0 0 0 0 W
0 0 0 0 0 0 0
0 0 0 W Y 0 0
0 0 0 C G B 0
0 0 0 R 0 0 0
0 0 0 0 0 B Y

P 0 G 0 0 B 0
Y 0 0 P 0 R 0
0 0 0 Y 0 0 0
0 0 0 R G 0 0
C W 0 0 0 0 0
0 0 0 0 0 C 0
W B 0 0 0 0 0

0 0 0 0 0 0 0
0 0 0 0 0 0 0
0 R B 0 B 0 0
0 C 0 0 0 0 0
0 0 0 G C R 0
G Y 0 W Y 0 0
0 0 0 0 0 0 W