0 O B 0 0 G
0 0 0 0 0 0
0 0 Y R 0 G
0 0 0 C 0 B
0 R Y 0 C O
0 0 0 0 0 0

Y 0 0 0 0 0
0 0 0 0 0 0
0 0 0 0 0 0
R G B G 0 0
Y B 0 R 0 0
0 0 0 0 0 0

0 0 0 0 B G
0 0 R 0 0 0
0 0 O 0 0 0
0 0 Y G 0 0
0 R 0 0 B 0
0 O Y 0 0 0

0 0 0 0 0 0
0 B O 0 O R
0 0 0 0 0 B
0 0 0 0 R G
G Y 0 0 Y 0
0 0 0 0 0 0

0 0 0 0 O 0
0 0 G 0 B 0
0 0 0 0 0 0
0 0 0 R 0 0
0 0 0 0 0 O
Y G Y R 0 B

Y 0 0 0 0 0
B 0 0 0 0 0
R B 0 G C 0
0 0 0 0 0 0
0 0 0 O G 0
R C O Y 0 0

G O 0 0 0 B
0 0 0 0 0 R
0 0 B R G 0
0 0 0 0 O 0
0 Y 0 0 Y 0
0 0 0 0 0 0

B 0 0 0 0 R
Y 0 0 0 0 0
O G 0 0 0 0
0 0 G Y 0 0
R 0 O B 0 0
0 0 0 0 0 0

R 0 0 0 0 0
G 0 0 0 0 0
0 0 0 O 0 0
O 0 0 B 0 0
0 0 Y G 0 0
B Y 0 R 0 0

0 0 0 0 0 0
R B 0 G 0 0
0 Y 0 0 0 0
0 O 0 0 0 R
0 Y 0 0 G B
O 0 0 0 0 0